25 20
#########################
#@.....................#
##################..s..#
#......................#
#......................#
#.....s.....#############
#...........#%%%%#......!
#...........#%%%%#......#
#####..######%%%%###..###
    #..#%%%%%%%%%%%#..#
    #..#%%%%%%%%%%%#..#
    #..#%%%%%%%%%%%#...##
  ###..###%%%%%%####...#
  #......#%%%%%%#......#
  #......########.......#
  #.................s...#
  #.......########......#
  #....w..#.....k#......#
  #..............#......#
  #######################
